#######################################################################
# VIC Model Parameters - 5.0
#######################################################################
# $Id$
#######################################################################
# [Simulation]
MODEL_STEPS_PER_DAY	1
SNOW_STEPS_PER_DAY	24
RUNOFF_STEPS_PER_DAY	24
STARTYEAR	1998
STARTMONTH	1
STARTDAY	1
STARTSEC	0
ENDYEAR	1998
ENDMONTH	12
ENDDAY	12
CALENDAR	PROLEPTIC_GREGORIAN
OUT_TIME_UNITS	DAYS

# [Energy Balance]
FULL_ENERGY	FALSE
CLOSE_ENERGY	FALSE

# [Soil Temperature]
FROZEN_SOIL	FALSE
QUICK_FLUX	TRUE
IMPLICIT	FALSE
QUICK_SOLVE	FALSE
NOFLUX	FALSE
EXP_TRANS	FALSE
GRND_FLUX_TYPE	GF_410
TFALLBACK	TRUE
SHARE_LAYER_MOIST	TRUE
SPATIAL_FROST	FALSE

# [Precipitation]
SNOW_DENSITY	DENS_BRAS
BLOWING	FALSE
BLOWING_VAR_THRESHOLD	TRUE
BLOWING_CALC_PROB	TRUE
BLOWING_SIMPLE	FALSE
BLOWING_FETCH	TRUE
BLOWING_SPATIAL_WIND	TRUE
COMPUTE_TREELINE	FALSE
CORRPREC	FALSE
SPATIAL_SNOW	FALSE

# [Turbulent Flux]
AERO_RESIST_CANSNOW	AR_406_FULL

# [Carbon]
CARBON	FALSE
RC_MODE	RC_JARVIS
VEGLIB_PHOTO	FALSE

# [Miscellaneous]

# [State Files]

# [Forcing]
FORCING1	./examples\213_6km\MeteForcing\forcings.
WIND_H	10.0
CANOPY_LAYERS	3

# [FORCE_TYPE]
FORCE_TYPE	AIR_TEMP    tas
FORCE_TYPE	PREC    prcp
FORCE_TYPE	PRESSURE    pres
FORCE_TYPE	SWDOWN  dswrf
FORCE_TYPE	LWDOWN  dlwrf
FORCE_TYPE	VP  vp
FORCE_TYPE	WIND    wind

# [Domain]
DOMAIN	./examples\213_6km\DomainFile\domain.nc

# [DOMAIN_TYPE]
DOMAIN_TYPE	LAT lat
DOMAIN_TYPE	LON lon
DOMAIN_TYPE	MASK    mask
DOMAIN_TYPE	AREA    area
DOMAIN_TYPE	FRAC    frac
DOMAIN_TYPE	YDIM    lat
DOMAIN_TYPE	XDIM    lon

# [Param]
PARAMETERS	./examples\213_6km\ParamFile\params_level1.nc
BASEFLOW	ARNO
JULY_TAVG_SUPPLIED	FALSE
ORGANIC_FRACT	FALSE
ALB_SRC	FROM_VEGPARAM
LAI_SRC	FROM_VEGPARAM
FCAN_SRC	FROM_VEGPARAM
SNOW_BAND	FALSE

# [Lake]
LAKES	FALSE
LAKE_PROFILE	FALSE

# [Routing]
ROUT_PARAM	

# [Output]
LOG_DIR	./examples\213_6km\VICLog/
RESULT_DIR	./examples\213_6km\VICResults
OUTFILE	fluxes
OUT_FORMAT	NETCDF4
AGGFREQ	NDAYS   1
COMPRESS	FALSE

# [OUTVAR1]
OUTVAR	OUT_RUNOFF
OUTVAR	OUT_BASEFLOW
OUTVAR	OUT_DISCHARGE

